1111111111111111111111111
1322252222222222222222221
1211121112111112111211121
1210121012100012101210121
1610121012100012101210161
1211121112111112111211121
1222222222224222222222221
1111161111111111111611111
1000121000000000001210001
1000121111111111111210001
1000122222222222222210001
1111121111112111111211111
0000022222226222222200000
1111121111112111111211111
1000122222222222222210001
1000121111111111111210001
1000121000000000001210001
1111161111111111111611111
1222222222222222222222221
1211121112111112111211121
1610121012100012101210161
1210121012100012101210121
1211121112111112111211121
1222222222222222222522231
1111111111111111111111111